[F,F,B,T,M,M,M,M,B,T]
[F,F,F,T,M,M,M,W,W,W]
[F,F,F,M,M,M,W,W,W,W]
[T,F,M,M,M,M,W,W,W,W]
[T,T,M,M,M,M,M,W,W,W]
[T,T,M,M,M,M,M,M,W,W]
[T,T,T,M,M,M,M,B,W,W]
[T,T,B,M,M,M,F,F,F,B]
[T,T,T,T,B,B,B,B,B,B]
[T,T,T,T,F,F,F,F,F,F]